Sun Apr 29 01:40:37 2018
sfntdiff (2.21217) (-d 1)  files:
< sfntdiff_data/regular.otf
> sfntdiff_data/bold.otf
'sfnt' differs.
< 00000000+00000016=00000016
> 00000000+00000016=00000016
'CFF ' differs.
< 000000e4+00000008=000000ec
> 000000e4+00000008=000000ec
'GPOS' differs.
< 00001018+000000b5=000010cd
> 00001064+000000b5=00001119
'OS/2' differs.
< 000006f8+00000003=000006fb
> 0000072c+00000003=0000072f
'head' differs.
< 00000674+00000008=0000067c
> 000006a8+00000008=000006b0
'hhea' differs.
< 000006d4+0000000d=000006e1
> 00000708+0000000d=00000715
'hmtx' differs.
< 000006ac+00000001=000006ad
> 000006e0+00000001=000006e1
'name' differs.
< 00000758+00000027=0000077f
> 0000078c+00000027=000007b3
